111111111111111
1EC0C0000000001
1000000X000P001
111000100000001
10000X000000001
111111111111111