111111111111111
1000C001X000CP1
1C0X0C0X0000101
1E1000000X00XC1
111111111111111