111111
1000C1
100001
1E0011
100CP1
111111