111111111111111
1000C001X000CP1
100X0C0X0000101
1E1C00000X00XC1
111111111111111