111111
1000C1
100001
1E0011
1001P1
1000C1
111111