1111111111
1C000C0011
100000C001
1P00C00C01
1C00001011
1C100010E1
1111111111